έχετε	you all have, do you all have, have
αυτές	these, they, them
έχουν	tastes, they have, have
αυτά	this, the things, these
τίνος	whose
απάντηση	an answer, response, a reply
ερώτηση	question, inquiry
ποιος	who, which, what
ποιανού	whose
πόσα	how, how much, how many
πώς	how, what
πόσο	how much
πού	where
γιατί	why, because
πότε	when
τι	what
κοντομάνικο	t-shirt, a t-shirt
πορτοφόλι	wallet, purse
τσέπη	pocket
γραβάτα	tie, necktie
μάλλινος	woollen, woolen, woollen one
μπότα	boot, buskin
εσώρουχο	underwear
ζώνη	zone, a belt, seatbelt
γάντι	glove
στολή	uniform, costume, a uniform
κόσμημα	jewellery, jewel, piece of jewellery
κασκόλ	scarf
καπέλο	hat, cap, a hat
κουστούμι	suit, a suit, costume
κάλτσα	sock
μπλούζα	blouse, a blouse, shirt (no buttons)
ρούχο	a piece of clothing, garment, piece of clothes
φοράει	wears, does she wear, is wearing
φοράω	wear
πουκάμισο	shirt, shirt (with buttons), a shirt
παλτό	a coat, coat, overcoat
παντελόνι	pants, pair of pants, trousers
φούστα	skirt, a skirt
παπούτσια	shoes
φόρεμα	dress, gown
γραβάτες	ties
γλυκά	sweet (adj. neut. plural), sweets, sweetest
γάντια	gloves
σοκολάτες	chocolates
πουκάμισα	shirts (n)(nom/acc)
φούστες	skirts
καπέλα	hats, caps
αυγά	eggs
ζώα	animals
παππούδες	grandparents, grandfathers
μπισκότα	cookies, biscuits
πιάτα	plates, dishes, the plates
πουλιά	birds
χελώνες	turtles, tortoises, are the turtles
φίλοι	friends
πάπιες	ducks, duck
άλογα	horses, horse meat
γάτες	cats
σκύλοι	dogs
ελέφαντες	elephants
εφημερίδες	newspapers, papers
βιβλία	books
μήλα	apples, dodgeball
ζέβρα	zebra
τίγρης	tiger
ερπετό	reptile, a reptile, crawler
λύκος	wolf
αλεπού	fox
λαγός	hare, jack rabbit
φίδι	snake, serpent, a snake
λιοντάρι	lion
θηλαστικό	mammal, a mammal
χάμστερ	hamster, hamsters
κότα	chicken, hen
έντομο	insect, bug, an insect
πεταλούδα	butterfly
καμηλοπάρδαλη	giraffe
αετός	eagle
καμήλα	camel
πίθηκος	ape, monkey
αράχνη	spider, a spider
ποντίκι	mouse, a mouse
πελεκάνος	pelican
καβούρι	crab
κατοικίδιο	pet, a pet
ζώο	animal, an animal
αρκούδα	bear
κουτάβι	puppy, pup
σκύλος	dog, a dog
ελέφαντας	elephant
χελώνα	turtle, tortoise, a turtle
άλογο	horse, a horse
πουλί	bird, a bird
πάπια	duck, (a) duck
γάτα	cat, a cat
παππούς	grandpa, grandfather, grandparent
συγγενής	relative, cognate
γιαγιά	grandmother, grandma
εγγονός	grandchild, grandson
νονός	godfather
μπαμπάς	dad, daddy
νονά	godmother
ξάδερφος	cousin
γάμος	marriage, wedding
οικογένεια	family, a family
αδέλφια	brother and sister, siblings, brothers
σύζυγος	woman, husband, wife
θείος	uncle
θεία	aunt
πατέρας	father, a father, dad
κόρη	daughter, a daughter
αδελφή	sister, a sister
γιος	son
αδελφός	brother
μωρό	baby, infant
γονιός	parent
μητέρα	mother
πάγος	ice
πατάτες	potatoes
κεφτές	meatball, a meatball
ροδάκινο	peach
λαχανικό	(a) vegetable
μπριζόλα	steak, chop
σοκολάτα	chocolate, chocolate milk
επιδόρπιο	dessert
πίτα	pita, pita bread, pie
λουκάνικο	sausage, hot dog, wiener
αχλάδι	pear
πιπέρι	pepper
παγωτό	ice cream
πατάτα	potato
καρπούζι	watermelon
βοδινό	beef
πεπόνι	a melon, (a) melon
χορτοφάγος	vegetarian, a vegetarian
ελαιόλαδο	olive oil
χοιρινό	pork
φρέσκο	fresh
κεράσι	cherry
γεύμα	meal, dinner, lunch
κρέας	meat
τσάι	tea, of tea
αγγούρι	cucumber
σαλάτα	salad, any salad, a salad
δείπνο	supper, dinner
φαγητό	food
αλάτι	salt
κρεμμύδι	onion
ζυμαρικά	pasta, macaroni, noodle
ντομάτα	tomato
χυμός	juice
τυρί	cheese, (some) cheese
φράουλα	strawberry
μπίρα	beer
φρούτο	fruit
ζάχαρη	sugar, (of) sugar
πρωινό	breakfast
νόστιμος	tasty, delicious
μεσημεριανό	lunch
σκόρδο	garlic
πίτσα	pizza, of pizza
κρασί	wine, of wine
πιάτο	plate, dish
ποτήρι	glass, cup, a glass of
αυγό	egg
κοτόπουλο	chicken
πορτοκάλι	orange (fruit), an orange, oranges
δικός	own
δικά	yours
δικό	own
δική	(my/your/his etc) own
μου	of mine, of me, me
της	her, to her, the
σας	you guys, your, of you
σου	you, to you, your
μας	to us, us, our
τους	the, for them, them
του	of the, the, him
ιταλία	Italy
ασία	Asia
ελλάδα	Greece
αθήνα	Athens
ευρώπη	Europe
αμερική	America
αυστραλία	Australia
από	from, of, since
μένω	stay, I'm staying, I reside
την	of, her, the
μιλάω	speak, talk, I speak
λίγο	a bit (of), a little bit, a little
εντάξει	alright, ok
αγγλικά	English
μιλάς	you speak, speak, talking
μιλάτε	speak, (plural| you) speak, (plural| you) talk
ελληνικά	Greek
μιλάει	speaks, speak, talking
πώς σε λένε	what is your name, how do they call you
δεν	do not, no, did not
αντίο	goodbye, bye
ορίστε	here you are, here, here is
πολύ	a lot of, too, very much
με λένε	my name is, they call me
χάρηκα	nice to meet you, I am happy, I was glad
ελένη	Helen, Eleni, Ellen
καλημέρα	good morning, good day
τα λέμε	see you soon, talk, be talking to you
καληνύχτα	good night
συγγνώμη	sorry, excuse me
καλησπέρα	good evening
γεια σας	hello, goodbye
γεια	hello, bye
με συγχωρείτε	excuse me, sorry
είστε	you are, are, you're
καλά	fine, well, good
πώς είσαι	how are you (infr/sing)
πώς είστε	how are you (pl/formal)
τρως	(you) are eating, you eat, do you eat
εσείς	y'all, you, you all
αυτοί	these, they
είσαστε	you are, you're, are you
πίνουν	drink, they are drinking, do ... drink
διαβάζω	read, study, I am reading
διαβάζετε	are you reading, you are reading, reading
είσαι	you should be, are you, you were
τρώνε	eating, are eating, they eat
πίνεις	you drink, do you drink, you are drinking
έχω	have, I have, got
είμαστε	we are, we're, are
διαβάζεις	Are you reading, study, (you) read
διαβάζουμε	(we) read, study, are studying
έχεις	do you have, (you) have, have you
διαβάζει	he/she reads, is studying, studies
εμείς	we, us
έχει	is, has got, tastes
παιδί	child, kid
μενού	menu
γάλα	milk
παιδιά	children, youngsters, kids
έχουμε	do we have, we have
βιβλίο	book
άντρες	husbands, men
κορίτσια	girls, girlfriends + possessive!
οι	the
γυναίκες	ladies, women, wives
εφημερίδα	newspaper, paper
διαβάζουν	(they) are reading, (they) are studying, read
αγόρια	boys, sons, boyfriends + possessive!
μια	a, one, an
τα	the, in the, them
τρώει	eats, is eating, does he eat
εσύ	you
πίνει	does she drink, he drinks, does he drink
πίνω	drink
τρώω	eat, I am eating, eating
μήλο	apple
αυτό	it, this
αγόρι	boy, boyfriend
μικρό	little, tiny, young
ένα	an, a, a pair of
αυτός	he, this
κορίτσι	girl
αυτή	she, this one, this
μία	an, a, one
εγώ	I
ένας	an, a, one
είμαι	be, I am, am
ταξί	taxi, taxi cab, cab
ξίδι	vinegar
ψάρι	fish
ψωμί	bread
καφές	coffee
ευχαριστώ	thanks, thank you, thank
παρακαλώ	please
ωρίων	Orion
τηλέφωνο	telephone, phone
σούπα	soup
σπαγγέτι	spaghetti
πάπρικα	paprika
θα ήθελα	I'd want, I'd like, I would want
θέατρο	theatre
θρόνος	throne
θα	they'll, i'd, you will
λεμόνι	lemon
γορίλας	gorilla
χολ	hall
σκελετός	skeleton
μεγάλο	great, large, a big
δα	da
δράμα	drama
χι	hi, hee, chi
όχι	no
αρχιτέκτονας	architect
xοσέ	José
γύρος	gyro, gyros, turn
μάνγκο	mango, mangos
γεια σου	hello, hi
τσιγάρο	cigarette
γυναίκα	woman
άντρας	man
ο	the
μαμά	mum, mama
υ	y, ypsilon, ee
η	the, that
ι	ee, i, yiota
τοποθεσία	site, location, place
όνομα	name
τοστ	toast
κουσκούς	couscous
στο	to the, the, in the
ντίσκο	disco
σινεμά	cinema, movie theater, movies
μουσείο	museum
βίντεο	video, a video, videos
με	me, on, to
ούζο	ouzo
σνακ	snack, a snack, snacks
βάζο	vase
είναι	is, it's, is he
αβοκάντο	avocado
ροζ	pink
ρύζι	rice
μι	m, mu, mee
μα	but
και	and
μίνι μάρκετ	minimarket, mini market
ναι	yes, yeah
το	the, it, in
να	may, to, that
νερό	water
καρότο	carrot
αν	if